NO      ./txts/blue.xpm
SO ./txts/orange.xpm
WE ./txts/green.xpm
EA ./txts/red.xpm

F 217, 238, 255
C 14, 39, 0



        1111111111111111111111111
        1000000000110000000000001
        1011000001110000000000001
        1001000000000000000000001
111111111011000001110000000000001
100000000011000001110111000011111
11110111111111011100000010001
11110111101111011101010010001 1
11000000111101011100000010001
10000000000000001100000010001
10000000000000001101010010001
1100000111010101111101111000111
11110111 1110101 1011110100S1
11111111 1111111 111111111111