NO      ./txts/blue.xpm
SO ./txts/orange.xpm
WE ./txts/green.xpm
EA ./txts/red.xpm

F 217, 238, 255
C 14, 39, 0

        1111111111111111111111111
        1000000000110000000000001
        1011000001110000000000001
        1001000000000000000000001
111111111011000001110000000000001
1000000000110000011101110S0011111
11110111111111011100000010001
11110111111111011101010001001
11000000110101011100000000101
10000000000000001100000010011
10000000000000001101010010001
1100000111010101111101111000111
11110111 1110101 101111010001
11111111 1111111 111111111111