NO ./txts/orange_rubiks.xpm
                                    SO ./txts/red_rubiks.xpm
WE ./txts/green_rubiks.xpm
EA ./txts/blue_rubiks.xpm
S ./txts/tnt64.xpm

F 217, 238, 255
C 74, 39, 0

1111111111111111111111111111111111111111111111111111111111111111111111111111111111111111
1100000000000000000000000000000000000000000000000000000000000000000000000000000000000011
1100000000000000000000000000000000000000000000000000000000000000000000000000000000W00011
1100000000000000000000000000000000000000000000000000000000000000000000000000000000000011
1100110011111111111111111111111111111111111111111111111111111111111111111111111111110011
1100110011111111111111111111111111111111111111111111111111111111111111111111111111110011
1111110011110011001100111100110011110000000000110011001111000000000000000011001100110011
1111110011110011001100111100110011110000000000110011001111000000000000000011001100110011
1100110000110011000000000000000000110011111111110000000000001111001100110000001100110011
1100110000110011000000000000000000110011111111110000000000001111001100110000001100110011
1100111100000000001111110011001100000011000000110011110011111111001111110011000000110011
1100111100000000001111110011001100000011000000110011110011111111001111110011000000110011
1100111111001100111100111111111111110000001111110000110000000011000011111111001111110011
1100111111001100111100111111111111110000001111110000110000000011000011111111001111110011
1100110000001100000000000000001100110011111100000011111111111111001111001111111100110011
1100110000001100000000000000001100110011111100000011111111111111001111001111111100110011
1100111111001100111111110011000000111111110000111111000000110011111100000011001100110011
1100111111001100111111110011000000111111110000111111000000110011111100000011001100110011
1100110000001100000011111111111111111100111100000000001100110011001100110000000000110011
1100110000001100000011111111111111111100111100000000001100110011001100110000000000110011
1100111100111100110011000000110011000000000000110011001100110011001100110011001111110011
1100111100111100110011000000110011000000000000110011001100110011001100110011001111110011
1100111111110000110000001100000000001100111111111111111111110000000000111111000000110011
1100111111110000110000001100000000001100111111111111111111110000000000111111000000110011
1100110011111100111100111100111100111100000000000000000011000011111100000011111111110011
1100110011111100111100111100111100111100000000000000000011000011111100000011111111110011
1100110000000000001100111111111111111111001111110011111111001111001111110000000000110011
1100110000000000001100111111111111111111001111110011111111001111001111110000000000110011
1100111100111100111100000000001100000011000000110000000000000000000000110011111100110011
1100111100111100111100000000001100000011000000110000000000000000000000110011111100110011
1100111100110000111100111111111100110011111100111100111100111100111111110000001111110011
1100111100110000111100111111111100110011111100111100111100111100111111110000001111110011
1100110000111100110000000000001100111111001111111111111100110000000011110011111100110011
1100110000111100110000000000001100111111001111111111111100110000000011110011111100110011
1100111100110000111100110011000000000000000011001111001111111100110000110011001100110011
1100111100110000111100110011000000000000000011001111001111111100110000110011001100110011
1100110000110011111111110011111111001111111111001100000011001100110011110000000000110011
1100110000110011111111110011111111001111111111001100000011001100110011110000000000110011
1100111100110011001100110000001100001111001111000000110000001100111111000011001100110011
1100111100110011001100110000001100001111001111000000110000001100111111000011001100110011
1100110000110011000000000011001111000000000000001100110011001100000011001111001100110011
1100110000110011000000000011001111000000000000001100110011001100000011001111001100110011
1111111111111111111111111111111111111111111111111111111111111111111111001111111111111111
1111111111111111111111111111111111111111111111111111111111111111111111001111111111111111
1100000000000000000000000000000000000000000000000000000000000000000000000000000000000011
1100000000000000000000000000000000000000000000000000000000000000000000020000000000000011
1111111111111111111111111111111111111111111111111111111111111111111111111111111111111111