NO ./txts/orange_rubiks.xpm
                                    SO ./txts/blue_rubiks.xpm
WE ./txts/green_rubiks.xpm
EA ./txts/red_rubiks.xpm


F 217, 238, 255
C 14, 39, 0

111111111111111111111111111111111111111
110000000000000000000000000000000000011
110000000000000000000000000000000000011
110001111111111111111111111111111110011
110001111111111111111111111111111110011
110001100000000001100110000001100110011
110001100000000001100110000001100110011
110001100000011001100000011000000110011
110001100000011001100000011000000110011
110001100111111001111111111111100110011
110001100111111001111111111111100110011
110001100001100000000000000000000110011
110001100001100000000000000000000110011
110001100111100111100111111111111110011
110001100111100111100111111111111110011
110001100000000110000110000000000110011
110001100000000110000110000000000110011
111111111111100110011110011001111110011
111111111111100110011110011001111110011
110000000000000110000000011000000000011
110E00000000000110000000011000000000011
110001111111100111111111111001111111111
110001111111100111111111111001111111111
110001100000000001100110000000000110011
110001100000000001100110000000000110011
110001100111100111100110011111100110011
110001100111100111100110011111100110011
110001100001100110000110011001100110011
110001100001100110000110011001100110011
110001111001100110011110011001100110011
110001111001100110011110011001100110011
110001100001100110000000011000000110011
110001100001100110000000011000000110011
110001111111111111111111111111111110011
110001111111111111111111111111111110011
110000000000000000000000000000000000011
110000000000000000000000000000000000011
111111111111111111111111111111111111111