NO      ./txts/blue.xpm
SO ./txts/orange.xpm
WE ./txts/green.xpm
EA ./txts/red.xpm


F 2000000, 238, 255
C 74, 39, 0


111111111111111
100000000000011
100000000000011
100000000000011
100000000000011
1000000N0000011
100000000000011
100000000000011
101111101111111
111111111111111