NO ./txts/orange_rubiks.xpm
SO ./txts/invalid_text.xpm
WE ./txts/green_rubiks.xpm
EA ./txts/red_rubiks.xpm

F 217, 238, 255
C 774, 39, 0


111111111111111111111111111111111111111111111111111
101000010000000000000000000000000000000000000000001
101000010000000000000000000000000000000000000000001
101000000000000000000000000000000000000000000000001
101000000000000000000000000000000000000000000000001
101000000000000000000000000000000000000000000000001
101000000000000000000000000000000000000000000000001
101000000000000000000000000000000000000000000000001
101000000000000000000000000000000000000000000000001
101000000000000000000000000000000000000000000000001
101000000000000000000000000000000000000000000000001
101000000000000000000000000000000000000000000000001
101000000000000000000000000000000000000000000000001
101000000000000000000000000000000000000000000000001
101000000000000000000000000000000000000000000000001
101000000000000000000000000000000000000000000000001
101000000000000000000000000000000000000000000000001
101000000000000000000000000000000000000000000000001
101000000000000000000000000000000000000000000000001
101000000000000000000000000000000000000000000000001
101000000000000000000000000000000000000000000000001
101000000000000000000000000000000000000000000000001
101000000000000000000000000000000000000000000000001
101000000000000000000000000000000000000000000000001
101000000000000000000000000000000000000000000000001
101000000000000000000000000000000000000000000000001
101000000000000000000000000000000000000000000000001
101000000000000000000000000000000000000000000000001
101000000000000000000000000000000000000000000000001
101000000000000000000000000000000000000000000000001
101000000000000000000000000000000000000000000000001
101000000000000000000000000000000000000000000000001
101000000000000000000000000000000000000000000000001
101000000000000000000000000000000000000000000000001
101000000000000000000000000000000000000000000000001
101000000000000000000000000000000000000000000000001
101000000000000000000000000000000000000000000000001
101000000000000000000000000000000000000000000000001
101000000000000000000000000000000000000000000000001
101000000000000000000000000000000000000000000000001
101000000000000000000000000000000000000000000000001
101000000000000000000000000000000000000000000000001
101000000000000000000000000000000000000000000000001
101000000000000000000000000000000000000000000000001
101000000000000000000000000000000000000000000000001
101000000000000000000000000000000000000000000000001
101000000000000000000000000000000000000000000000001
101000000000000000000000000000000000000000000000001
101000000000000000000000000000000000000000000000001
101000000000000000000000000000000000000000000000001
101000000000000000000000000000000000000000000000001
101000000000000000000000000000000000000000000000001
101000000000000000000000000000000000000000000000001
101000000000000000000000000000000000000000000000001
101000000000000000000000000000000000000000000000001
101000000000000000000000000000000000000000000000001
101000000000000000000000000000000000000000000000001
101000000000000000000000000000000000000000000000001
101000000000000000000000000000000000000000000000001
101000000000000000000000000000000000000000000000001
101000000000000000000000000000000000000000000000001
101000000000000000000000000000000000000000000000001
101000000000000000000000S00000000000000000000000001
101000000000000000000000000000000000000000000000001
101000000000000000000000000000000000000000000000001
101000000000000000000000000000000000000000000000001
101000000000000000000000000000000000000000000000001
101000000000000000000000000000000000000000000000001
101000000000000000000000000000000000000000000000001
100000000000000000000000000000000000000000000000001
100001000000000000000000000000000000000000000000001
100000000000000000000000000000000000000000000000001
111111111111111111111111111111111111111111111111111